################
#00000000000000#
#00000#####0000#
#000000000#0000#
#000000000#0000#
#000000000#0000#
#000000000#0000#
#0000######0000#
#00000000000000#
################
