########
#0#0#0##
#000000#
#00##00#
#0###00#
#00###0#
#0####0#
########