11111111
10101011
10000001
10011001
10111001
10011101
10111101
11111111