###############
#0100#12300120#
#01#09#430##00#
####009111##10#
#0001022011110#
####1221121200#
###############