########
#111111#
#333331#
#111111#
#111111#
#111111#
########